#####從省從古字型編外的#####
尊	寸
歸	㱕
昷	𥁕
#孝老	耂
農	莀
憂	㥑
瑣	𧴪
共	廾
瞢	𥄕𮎳
沒	𠬸
殿	𡱂
釐	𠩺
罔	网
錽	𡕢
襄	𤕦
難嘆	𦰩
粲	𣦼
散	㪔
殺	杀
鑿	凿
竟兢競	竞
綌	卻
枿	卉
化	𠤎
處	処
隙	𡭴
肇	肁
徹	𬴲𰕎
微	𢼸
頤	𦣞
畢	𠦒
秭	𠂔
親	亲
秭	𠂔
熒	𬊇炏
爾	尒
遣	𠳋
麗	丽
盥	泴
羅	䍜
乘	乗
冥幂	冖
兩	㒳
那冉	冄
厚	㫗
節即	卩
叟	叜
貞鼎	貝	僅形同，與「貝」形不同源
去	夻
鼓	壴
晃光	灮
宜	宐
宮	宫
#####從上級聲旁的#####
吾	五
冒	冃
蚤	㕚
翠	卒
考	丂
儥坴圥	六
畾	雷
累	厽
遂	㒸
筆	聿
酋	酉
崇	宗
府	付
科委	禾
奉夆豐封邦逢	丰
蒙	冡
尌	豆
重童	東
屬	蜀
最聚	取
悤㚇	囪	㚇從布之道、裘錫圭說
從	从
空巩貢	工
斛	角
卷	龹
數	婁
庸#甬	用
貫	毌
否丕咅	不
背	北
卞	弁
盆彬	分
費	弗
薨	瞢
任	壬
在哉存	才
吏事	史
賊	則
朁兓	兂
愛㤅既	旡
酓含侌禽岑	今
圣灰有右	又
員袁睘	〇
熊	能
波	皮
番	釆
發癹	癶
孟	皿
莽	茻
屠諸署暑豬都著書	者
黨堂敞當	尚
到召	刀
然	肰
虘查助	且
將臧壯	爿
喪	桑
霜	相
孱	孨
蔡	祭
賈	襾
固胡辜居	古
渠	巨
英	央
阿奇哥	可
旱	干
晏	安
匽	妟
丐曷	匄
獻	鬳
艾	乂
肴	爻
矍瞿	䀠
廣	黃
㞷匡狂	王
咼叧	冎
雚	雈
宛	夗
厥	欮
閭	呂
盧虜慮	虍
虖	乎
路客	各
厲	萬
與舁	与
達羍	大
舍除	余
閻	臽
毘坒比	匕
鼻	畀
密宓謐	必
致室	至
圼	日
#盡	津
新	辛
稽耆	旨
殹	医
弦	玄
幼幽	幺
屖	尸
繇	䍃
崩	朋
敝	㡀
覓派	𠂢
寧	寍
責	朿
前	歬
韱	㦰
嬰	賏
鬩	兒
㓞	丯
垚	堯
厭	猒
歷厤	秝
聖廷呈戜	𡈼
枼	世
霸	䩗
繁	緐
國	或
條	攸
闌	柬
御卸	午
義	我
衛	韋
鹽	監
施	也
等特寺時市蚩臺志	之
尃	甫
亭	丁
式代	弋
庶度席橐宕	石
那	冄
亶	旦
春	屯
風	凡
布	父
嚴	敢
喬	高
砉	圭
弘穹	弓
景	京
局	句
麋	米
麥猌	來
胥楚	疋
巟	亡
感	咸
烕	戌
忽	勿
養	羊
哀	衣
夜	亦
屑	䏌
恩	因
雩夸亏	于
位	立
完	元
字	子
㕟蒯	凷
褱鰥	眔
遺	貴
君	尹
屈	出
專	叀
思䙴	囟
閔吝	文
禁	林
台	㠯
普	並
旁	方
百	白
展	㠭
匿	若
脅	劦
劉留	卯
廉	兼
䜌	聯
牆	爿
賴	剌
危	厃
亨享	亯
定	正
包	勹
追垖	𠂤
㡿	屰	#從布之道說
斥	乇	#即㡯，從布之道說
道	首
倝	㫃
於	烏
刁	刀
每	母
㚅	夅
其	丌
冋	冂
約	勺
切	七
剝	彔
匀軍	旬
鄉	卿
彥產炭	厂
厓	圭
參	彡
受	舟
臨	品
康唐	庚
啇	帝
壹	吉
夋	允
奴如	女
宣	亘
憲	害
容	公
少肖雀	小
履	眉
#####替代的#####
磊	厽
彪	髟
匘	夒	#從布之道、陳劍之說
糸絲兹	幺	#古字同，多音分化
#####同形的#####
肘守	寸
唯椎淮崔隼	隹
蟲虺	虫
狖冗	宂
橇	毳
奔賁	卉
咢	噩
駁	爻