队	隊
𬜯	㒼
满	滿
満	滿	# 日本
[夹]	㚒
软	軟
继	繼
[急]	㥯
[⿳爫𫜹心]	㥯	# 日本
隐	隱
隠	隱	# 日本
显	㬎
湿	濕
壳	㱿
戏	戲
[⿱亠⿲丶⿰丨丨丶]	䜌
应	應
龀	齔
万	萬
厉	厲
[不1]	褱
与	與
窜	竄
义	義
乱	亂
进	進
亚	亞
坛	壇罎
个	個
冯	馮
来	來
麦	麥
阴	陰
仑	侖
仓	倉
伞	傘
备	[⿱至用]
奁	奩
佥	僉
㑒	僉	# 日本
[卖]	𧶠
[売]	𧶠	# 日本
児	兒	# 日本
两	兩
両	兩	# 日本
宾	賓
风	風
凤	鳳
则	則
贼	賊
刘	劉
[办]	劦
叶	葉
劳	勞
[⿱艹冖2]	劳
労	勞	# 日本
㐫	𡿺
区	區
厌	厭
压	壓
圧	壓
参	參
仅	僅
[又]	𦰩
丽	麗
适	適
呙	咼
过	過
员	員
贠	貟
启	[⿰户攵]
丧	喪
乔	喬
单	單
単	單	# 日本
啬	嗇
严	嚴
厳	嚴	# 日本
嚣	囂
国	國
图	圖
図	圖	# 日本
陆	陸
[执1]	埶
[执2]	執
尧	堯
尭	堯	# 日本
报	報
壮	壯
壶	壺
寿	壽
夹	夾
奂	奐
鸡	鷄
郑	鄭
夺	奪
奋	奮
赑	贔
娄	婁
数	數
妇	婦
婴	嬰
[⿱𭕄女]	嬰	# 日本
孙	孫
[⿱𭕄冖]	𦥯
实	實
実	實	# 日本
[宁]	寧
丬	爿
将	將
壮	壯
专	專
团	團
寻	尋
树	樹
对	對
尝	嘗
赏	賞
属	屬
冈	岡
[⿱ス工]	巠
[圣2]	巠	# 日本
巣	巢	# 日本
帅	帥
师	師
带	帶
带	帶	# 日本
这	這
帘	廉
[广]	廣
広	廣	# 日本
费	費
従	從	# 日本
圣	聖
总	悤
恵	惠	# 日本
爱	愛
虑	慮
庆	慶
戋	戔
㦮	戔	# 日本
顾	顧
戻	戾	# 日本
泪	淚
扫	掃
条	條
务	務
币	幣
斩	斬
断	斷
[⿹𠄎⿰丿丿]	昜
[⿱𠂉⿹𠄎⿰丿丿]	[⿱𠂉昜]
伤	傷
阳	陽
时	時
昼	晝
晔	曄
昙	曇
书	書
层	層
会	會
庙	廟
体	體
晋	晉
东	東
[⿻⿻𠃋一⿻𠃌八]	柬
枭	梟
枣	棗
业	業
乐	樂
楽	樂	# 日本
涩	澀
岁	歲
归	歸
声	殸
[⿱免冫]	毚
汇	匯
渊	淵
乌	烏
灭	烕
烦	煩
[⿱艹冖1]	𤇾
荣	榮
称	爯
为	爲
[啬]	[嗇]
牵	牽
慭	憖
狱	獄
兽	獸
献	獻
[⿱⺌贝]	[⿱⺌貝]
产	産
审	審
亩	畝
毕	畢
画	畫
当	當
叠	疊
发	發髮
邓	鄧
灯	燈
発	發	# 日本
盖	蓋
艳	豔
盗	盜
尽	盡
兰	蘭
监	監
卢	盧
众	衆
梦	夢
赘	贅
标	標
际	際
苏	蘇