䥢	隆
㚘	伴
乿	治
㱚	殘
㳭	㳄
㹜	狺
㿟	皎
䩻	䩗
觕	粗
做	作
㐰	信
仝	同	# 又同「全」
䲴	鴆
佨	孕
㝊	守
珡	琴
琹	琴
釠	亂
亖	四
㰻	喜
㐂	喜
斈	學
㝕	寍
尟	鮮	# 「少」義
赻	鮮	# 「少」義
㞤	岑
㞥	岑
碞	嵒
秊	年
覍	弁
䨮	雪
䬌	彪
淲	彪
颩	彪
㤫	徳
眘	慎
朢	望
枿	蘖
㮆	蘖
螙	蠹
汓	泅
囦	淵
湌	餐
犇	奔
筭	算
竵	歪