#待校
#本表爲參考用，不參與程序運行。
#本表收錄所有二級聲旁，並酌情合併。不需要合併的用
#####多音#####
唯椎崔隼淮	隹	唯WI，崔CUI，椎TUI
㡿㡯斥	斥	㡯TAK，㡿ŊAK，形混
氏	氏	TE，ge
束	束	SOK，TOK
寸肘守	寸	肘/尊音
甜舌咶	舌	咶=⿱氏口，形混
爻駁	爻	KAU，PAUK，形混
帚掃	帚	不同音
蟲虺	虫
眔鰥	眔
豚彖豕	豕
毳橇	毳
岑今	今
綌谷	谷
嬴羸	𣎆
#####省形同#####
罔羅	网
刪	冊
役	殳
造	告	不同源
祝	兄
敦	享
斷	㡭
卉奔賁	卉
牆	嗇
剌賴	束
#####多形#####
卩己巴㔾		卩形作卩㔾己巴
噩咢
鬼畏
無舞
乞气
它也
予呂
止之㞢
習傝
烏於
于亏
爾尒
皃㫐
易益
#####多音多形#####
倝斿	㫃	㫃幹作倝KAN，㫃游作斿LU
辥豙乂辭薩	䇂	豙乂音ŊAT，辥音(S)ŊAT，薩音SŊAT，辭音LƏ
冘冗宂穴	冘	宂LU，冘TƏM，冗NOŊ三音
乙乚		CET，ɁIT
#####轉注#####
老孝考	耂
彡三		存疑
皇王	王
用同
卣酉	酉
#####原本聲符中分離出#####
廷呈聖	𡈼	聖本無𡈼
戜	呈	呈從𡈼聲
啇	帝
哥阿奇	可
尃	甫
青星省	生
如奴	女
召到刁	刀
定	正	正從丁聲
亭正成	丁
荅翕	合
固居胡辜	古
時等特	寺	寺從之聲，時古旹，之聲
市蚩臺寺志	之
少肖雀	小
當黨堂敞	尚
甬庸	用
隋	隓
義	我
枼	世
責	朿
式代	弋
奔賁	卉	奔賁同，本卉聲
庶度席橐宕	石
那	冉
否丕咅	不
臤	臣
赫	赤
舜夋	允	存疑
亶	旦
春	屯
次	次	次非二聲
造	艸	造非告聲，上方屮從艸省聲，存疑
風	凡
彬	焚
奉夆豐封邦	丰
逢	夆	夆爲丰聲
布	父
盍	去
旱	干
嚴	敢
喬	高
路客	各
宣	亘
唐康	庚
貢空巩	工
翁松容	公
躬	宮	存疑
骨咼叧	冎
晃	光
厓砉	圭
彥產炭	厂
豦處虛膚盧虜慮	虎
廣	黃
國	或
既㤅	旡
愛	㤅	㤅爲旡聲
蔡	祭
曷	丐
廉	兼
闌	柬
弘穹	弓
㚅贛	夅
酓含侌禽	今
景	京
收句	丩
局	句	句爲丩聲
卷	龹
有右圣	又
圥	六
坴	圥	圥爲六聲
累雷纍	畾
留劉	卯
數	婁
罷買	羅	羅省作网，存疑
莽莫	茻
麋	米
冥	冖
幂	冥	冥爲冖聲
綿	縣
每毐毋	母	毐從母存疑
敏	每	每爲母聲
內	入
朔㡿	屰
斥	乇
年信	人
弱	尿
闌	柬
波	皮
將臧牆壯	爿
虘查助	且
最聚	取
任	壬
圼	日
府	付
嗇麥猌	來
袞兗	㕣
吏事	史
胥楚	疋
屬	蜀
壴	豆
尌	壴	壴從豆聲
穌魯	魚
遂	㒸
寸	尊	存疑
戴	戠	存疑
外	月
厲	萬
喪	桑亡	存疑
巟罔	亡
匡㞷	王
吾	五
卸	午
御	卸	卸從午聲
伊	尹尸	存疑
屖	尸
感	咸
閻	臽
霜	相
親新	辛
烕	戌
忽	勿
奄	甲	存疑
匽	妟
厭	猒
英	央
養羌	羊
肴	爻
繇	䍃	䍃爲繇省
施	也
哀	衣
艾	乂
夜	亦
屑	䏌
恩	因
條	攸
酋	酉
夸雩粵	亏
閭	呂
舍除	余
互耶与	牙
與	与	与爲牙變形
位	立
完	元
宛	夗
旬訇	勻
賊	則
屠諸署書暑都著豬	者
稽耆	旨
在哉	才
追	𠂤
字	子
翠	卒
差	左
孟	皿
晏	安
癹	癶
發	癹	癹從癶聲
兓	兂
朁	兓	兓從兂聲
厤	秝
厥	欮
宓謐	必
密	宓
知彘寅	矢
冃	冒
追	垖
崇	宗
褱	鰥
㕟蒯	凷
遺	貴
考	丂
道	首
育㐬	𠫓
君	尹
筆	聿
屈祟	出
蒙	冡
重童	東
專	叀
悤	囪
從	从
委科	禾
貫	毌
背	北
卞	弁
盆	分
費	弗
薨	瞢
戴	戠
思	囟
員袁肙	〇
睘	袁	袁從〇聲
閔吝	文
禁	林
翌	異	翼省
台	㠯
普	並
旁	方
百	白
番	釆
繁	緐
表	毛
展	㠭
匿	若
然	肰
難	嘆	嘆爲𦰩形
喪	桑
孱	孨
賈	襾
渠	巨
卻	綌
矍	瞿	瞿從䀠聲
瞿	䀠
虖	乎
鹽	監
鄉	卿
亨	享
侃	衍
羍	大
達	羍	羍從大聲
比	匕
毘坒	比	比從匕聲
鼻	畀
致室	至
津	盡
即	卩
節	即	即從卩聲
叔	尗
弦	玄
戛	頁	存疑
幼幽	幺
忝	天
崩	朋
敝	㡀
弭	耳
覓	派
貞	鼎
寧	寍
前	歬
嬰	賏
鬩	兒
㓞	丯
堯	垚
厤	秝
歷	厤	厤從秝聲
脅	劦
霸	䩗
約	勺
